110992 0 11
131950 0 11
150676 0 11
168636 0 11
172068 0 11
196475 0 11
199823 0 11
203105 0 11
206454 0 11
219282 0 11
222731 0 11
